1111111111
2221111111
1121111111
1121111111
1122222211
1111111211
1111111211
1111111222
1111111111
